|                              |
|                              |
|                              |
|                              |
|                              |
|                              |
|                              |
|                              |
|                              |
|                              |
|                              |
|                              |
|                              |
|                              |
|                              |
|                         f    |
|   x       s                  |
gggggggggggggggggggggggggggggggg
gggggggggggggggggggggggggggggggg
gggggggggggggggggggggggggggggggg
gggggggggggggggggggggggggggggggg
gggggggggggggggggggggggggggggggg
gggggggggggggggggggggggggggggggg
gggggggggggggggggggggggggggggggg
