|                              |
|                              |
|                              |
|                              |
|                              |
|                              |
|                              |
|                              |
|                              |
|                              |
|                              |
|                              |
|                              |
|                              |
|                              |
|                              |
|                              |
|             =                |
|                              |
|          x     s         f   |
gggggggggggggggggggggggggggggggg
gggggggggggggggggggggggggggggggg
gggggggggggggggggggggggggggggggg
gggggggggggggggggggggggggggggggg
