|                              |
|                              |
|                              |
|                              |
|                              |
|                              |
|                              |
|                              |
|                              |
|       s                      |
|                              |
|                              |
|ggggg                   s     |
|                              |
|           ====               |
|                         f    |
|   x       s                  |
ggggggggggggggggggg^^^^^^^^^^^^^
gggggggggggggggggggggggggggggggg
gggggggggggggggggggggggggggggggg
gggggggggggggggggggggggggggggggg
gggggggggggggggggggggggggggggggg
gggggggggggggggggggggggggggggggg
gggggggggggggggggggggggggggggggg
