|                              |
|                              |
|                              |
|                              |
|                              |
|                              |
|                              |
|                              |
|                              |
|                              |
|                              |
|                              |
|                              |
|                              |
|                              |
|                         f    |
|   x                          |
gggggggggggggggggggggggggggggggg
gggggggggggggggggggggggggggggggg
gggggggggggggggggggggggggggggggg
gggggggggggggggggggggggggggggggg
gggggggggggggggggggggggggggggggg
gggggggggggggggggggggggggggggggg
gggggggggggggggggggggggggggggggg